{
	"numX": 13,
	"numY": 9,
	"size": [64, 64],
	"start": [32, 32],
	"tileNames": ["", "ProtoCoin", "ProtoBox", "Tile01", "Tile02", "Tile03", "ProtoGhost"],
	"tiles": [0, 0, 0, 0, 0, 0, 0, 0, 0, 0, 0, 0, 0,
			  1, 1, 0, 0, 6, 0, 0, 0, 0, 0, 0, 1, 1,
			  4, 5, 0, 0, 0, 0, 0, 0, 0, 0, 0, 3, 4,
			  0, 0, 0, 0, 1, 1, 1, 1, 1, 0, 0, 0, 0,
			  0, 0, 0, 0, 3, 4, 4, 4, 5, 0, 0, 0, 0,
			  1, 1, 0, 0, 0, 0, 0, 0, 0, 0, 0, 1, 1,
			  4, 5, 0, 0, 0, 0, 0, 0, 0, 0, 0, 3, 4,
			  0, 0, 2, 0, 0, 0, 0, 0, 0, 0, 2, 0, 0,
			  4, 4, 4, 4, 4, 4, 4, 4, 4, 4, 4, 4, 4]
}
